{
  "name": "Demo Map",
  "width": 16,
  "height": 16,
  "player": { "x": 3.5, "y": 3.5, "dir": 0.3141592653589793 },
  "grid": [
    1, 1, 1, 1, 1, 1, 1, 1, 1, 1, 1, 1, 1, 1, 1, 1,
    1, 0, 0, 0, 0, 0, 0, 0, 0, 0, 0, 0, 0, 0, 0, 1,
    1, 0, 3, 0, 0, 0, 0, 0, 0, 0, 0, 0, 0, 4, 0, 1,
    1, 0, 3, 0, 0, 0, 0, 0, 0, 0, 0, 0, 0, 4, 0, 1,
    1, 0, 3, 0, 2, 2, 2, 0, 0, 5, 5, 5, 0, 4, 0, 1,
    1, 0, 3, 0, 2, 0, 2, 0, 0, 5, 0, 5, 0, 4, 0, 1,
    1, 0, 3, 0, 2, 0, 2, 0, 0, 5, 0, 5, 0, 4, 0, 1,
    1, 0, 0, 0, 2, 2, 2, 0, 0, 5, 5, 5, 0, 4, 0, 1,
    1, 0, 0, 0, 0, 0, 0, 0, 0, 0, 0, 0, 0, 0, 0, 1,
    1, 0, 0, 0, 0, 0, 0, 0, 0, 0, 0, 0, 0, 0, 0, 1,
    1, 0, 0, 0, 0, 0, 0, 0, 0, 0, 0, 0, 0, 0, 0, 1,
    1, 0, 0, 0, 0, 0, 0, 0, 0, 0, 0, 0, 0, 0, 0, 1,
    1, 0, 0, 0, 0, 0, 0, 0, 0, 0, 0, 0, 0, 0, 0, 1,
    1, 0, 0, 0, 0, 0, 0, 0, 0, 0, 0, 0, 0, 0, 0, 1,
    1, 0, 0, 0, 0, 0, 0, 0, 0, 0, 0, 0, 0, 0, 0, 1,
    1, 1, 1, 1, 1, 1, 1, 1, 1, 1, 1, 1, 1, 1, 1, 1
  ]
}
